S,S,S,S,S,S,S,S,S,S,S,S,S,S,S,S,S,S,S,S,S,S,S,S,S,S,S,S,S
S,S,S,S,S,S,S,S,S,S,S,S,S,S,S,S,S,S,S,R,S,S,S,S,S,S,S,S,S
S,S,S,S,S,S,S,S,S,S,S,S,S,S,S,S,S,S,S,R,S,S,S,S,S,S,S,S,S
S,S,S,S,S,S,S,S,S,S,S,S,S,S,S,S,S,S,S,R,S,S,S,S,S,S,S,S,S
S,S,S,S,S,S,S,S,S,S,S,S,S,S,S,S,S,S,S,R,S,S,S,S,S,S,S,S,S
R,R,R,R,R,R,R,R,R,R,R,R,R,S,S,S,S,S,S,R,S,S,S,S,S,S,S,S,S
S,S,S,S,S,S,S,S,S,S,S,S,R,S,S,S,S,S,S,R,S,S,S,S,S,S,S,S,S
S,S,S,S,S,S,S,S,S,S,S,S,R,S,S,S,S,S,S,R,R,R,R,R,R,S,S,S,S
S,S,S,S,S,S,S,S,S,S,S,S,R,S,S,S,S,S,S,R,S,S,S,S,S,S,S,S,S
S,S,S,S,S,S,S,S,S,S,S,S,R,S,S,S,S,S,S,R,S,S,S,S,S,S,S,S,S
S,S,S,S,S,S,S,S,S,S,S,S,R,R,R,S,S,S,S,R,S,S,S,S,S,S,S,S,S
S,S,S,S,S,S,S,S,S,S,S,S,S,S,S,S,S,S,S,R,S,S,S,S,S,S,S,S,S
S,S,S,S,S,S,S,S,S,S,S,S,S,S,S,S,S,S,S,S,S,S,S,S,S,S,S,S,S
S,S,S,S,S,S,S,S,S,S,S,S,S,S,S,S,S,S,S,S,S,S,S,S,S,S,S,S,S
S,S,S,S,S,S,S,S,S,S,S,S,R,R,R,R,R,S,S,R,S,S,S,S,S,S,S,S,S
S,S,S,S,S,S,S,S,S,S,S,S,R,S,S,S,S,S,S,R,S,S,S,S,S,S,S,S,S
S,S,S,S,S,S,S,S,S,S,S,S,R,S,S,S,S,S,S,R,S,S,S,S,S,S,S,S,S
S,S,S,S,S,S,S,S,S,S,S,S,R,S,S,S,S,S,S,R,S,S,S,S,S,S,S,S,S